*************
*     *******
*     *******
*************
**********  *
***   *******
***   *******
*************